나 너 싫어하다	나 너 싫어
나 너 짜증	너 짜증나
사감 무섭다	사감선생님 무서워
사감 때문 짜증	사감선생님 때문에 짜증나
너 대박 빠르다	너 되게 빠르다
너 비율 좋다	너 비율 좋다
나 오늘 청소당번	나 오늘 청소당번이야
나 지름길 가다	나 지름길로 갈래
나 배부르다 우유 때문	나 우유먹어서 배불러
나 친구 똑똑하다	내 친구 똑똑해
너 못생김	너 못생겼어
나 동대문 가다	나 동대문 가
너 어디 가다	너 어디 갈거야
너 기분	기분이 어때
너 때문 답답	너 때문에 답답해
오늘 더워 짜증	오늘 더워서 짜증나
오늘 춥다	추워
나 배고프다	배고파
밥 형편없다	급식 별로야
오늘 온도 차다	오늘 추워
나 사감 불복종	어제 진술서 썼어
너 나이	너 몇살이야